####################
#..................#
#..................#
#..................#
#..................#
#..................#
#....B.............#
#..................#
#..................#
#..................#
#..................#
#..................#
####################