####################
#..................#
#..O...............#
#....P.............#
#..@...............#
#..................#
#....B.............#
#..O...............#
#.....E............#
#..................#
#..................#
#..................#
####################