####################
#..................#
#..................#
#....P.............#
#..@...............#
#..............O...#
#..................#
#..O...............#
#.....E............############
#..................#...B...#..#
#..................#..........#
#....O....O........#.......#..#
#..................#.......#..#
#.....O............#########..#
#..............O..............#
#.............................#
###############################