###############################
#.E...........................#
#................O............#
#.............................#
#..@.......O.......O....O.....#
#..O..........................#
#..O.......O...O..............#
#..O..........................#
#..................############
#............O.....#...B......#
#..................#..........#
#....O....O........#..........#
#..................#..........#
#.....O............#######....#
#...........O.................#
#.............................#
###############################